[
[10,1,7,2,3,3,1,0,2],
[6,4,14,5,15,6,2,1,0],
[2,7,2,1,4,2,0,1,2],
[6,3,0,1,0,1,0,1,2],
[8,3,0,1,0,1,0,1,2]
]